NO assets/sprites/mossystone.xpm
SO assets/sprites/bluestone.xpm
WE assets/sprites/greystone.xpm
EA assets/sprites/yellowstone.xpm

C 225,30,150
F 220,100,0

111111111111
100000000001
100000000001
1000000000N1
111111111111